1111111111111111111111111111111111111111111111111111111
100E000C00000000000000000100000000000000000000000000001
100000000P000000000000000000000000000000000000000000001
1000000000111111111111110000000000000000000000000000001
100E000C00000000000000000000000000000000000000000000001
100000000000111110000000000000000000000000C000000000001
1000000000000000000000000000000000000000000000000000001
100E000C00000000000000000000000000000000000000000000001
1000000000000000000001111100000000000000000000000000001
1000000000000000000000000000000000000000000000000000001
1000000000000000000000000000000000000000000000000000001
1111111111111111111111111111111111111111111111111111111
