1111111111111111111111111111111111111111111111111111111
100E000C000000000000000001000010000000000000000000000C1
100000000P000000000000000C00000000000000000000000000001
1000000000111111111111110000000000000000000000000000001
100E000C001000000000000000000000000C0000000000000000001
1000000000101111100000000000000000000000000000000000001
10000000001000000000000000C0000000000000000000000000001
100E000C0010000000000000000000000000000000C000000000001
1000000000100000000001111100000000000000000000000000001
1000000000100000000000000000000000000000000000000000001
1000000000100000000000000000C00000000000000000000000001
1111111111111111111111111111111111111111111111111111111
