111111111111
100E000C0001
100000000P01
100000000001
100E000C0001
100E000C0001
111111111111
